****************
****************
SSSSSSSSSSSSSSSS
SSSSSSSSSSSSSSSS
SSSSSSSSSSSSSSSS
SSSSSSSSSSSSSSSS
***************S
***************N
NNNNNNNNNNNNNNNN
NNNNNNNNNNNNNNNN
NNNNNNNNNNNNNNNN
NNNNNNNNNNNNNNNN